[][][][][][][][][][][]
[]==================[]
[]==================[]
[][][][][][]==[][][][]
[]============[]====[]
[]==================[]
[]============[]====[]
[]============[](==)[]
[]============[][][][]
[]==================[]
[]==================|m
[]==================[]
[][][][][][][][][][][]
