[][][][][][]
 |========[]
[]========[]
[]========[]
[]========[]
[]========[]
[][][][][][]
